11111111111111111
10000222222200001
10101210101210101
10022220000202221
10121212121210121
10020202222222221
12121212121010121
12020202022022021
12121010101012121
12222200022222021
12101210121012121
12220200222202201
10121010101212101
10022222022200001
10101010121210101
10000222222220001
11111111111111111