11111111111111111
10000000000000001
10000000000000001
10000000000000001
10000000000000001
10000000000000001
10000000000000001
10000000000000001
10000000020000001
10000002000000001
10002000000000001
10000020000000001
10000000002000001
10000020000000001
10000000000000001
10000000000000001
11111111111111111